"filename", "language", "TypeScript", "comment", "blank", "total"
"f:\Acadimic\SVU\ITE\S23\BPR601\projects\nestjs_bpr601_svu_server\src\api\favorite\favorite.controller.ts", "TypeScript", 16, 0, 1, 17
"f:\Acadimic\SVU\ITE\S23\BPR601\projects\nestjs_bpr601_svu_server\src\api\favorite\favorite.service.ts", "TypeScript", 16, 0, 3, 19
"f:\Acadimic\SVU\ITE\S23\BPR601\projects\nestjs_bpr601_svu_server\src\api\favorite\models\schemas\favotire.schema.ts", "TypeScript", 0, 0, -1, -1
"f:\Acadimic\SVU\ITE\S23\BPR601\projects\nestjs_bpr601_svu_server\src\api\payments\models\enums\payment_method.enum.ts", "TypeScript", 4, 0, 0, 4
"f:\Acadimic\SVU\ITE\S23\BPR601\projects\nestjs_bpr601_svu_server\src\api\payments\models\schemas\payment.schema.ts", "TypeScript", -1, 0, -1, -2
"f:\Acadimic\SVU\ITE\S23\BPR601\projects\nestjs_bpr601_svu_server\src\api\payments\payments.service.ts", "TypeScript", 12, 0, 1, 13
"f:\Acadimic\SVU\ITE\S23\BPR601\projects\nestjs_bpr601_svu_server\src\api\reservable\models\schemas\reservable.schema.ts", "TypeScript", 3, 0, 0, 3
"f:\Acadimic\SVU\ITE\S23\BPR601\projects\nestjs_bpr601_svu_server\src\api\reservable\reservable.controller.ts", "TypeScript", 14, 0, 0, 14
"f:\Acadimic\SVU\ITE\S23\BPR601\projects\nestjs_bpr601_svu_server\src\api\reservable\reservable.service.ts", "TypeScript", 37, 0, -1, 36
"f:\Acadimic\SVU\ITE\S23\BPR601\projects\nestjs_bpr601_svu_server\src\api\reservations\models\dtos\create_reservation.dto.ts", "TypeScript", 39, 0, 6, 45
"f:\Acadimic\SVU\ITE\S23\BPR601\projects\nestjs_bpr601_svu_server\src\api\reservations\models\enums\ReservationStatus.enum.ts", "TypeScript", -5, 0, 0, -5
"f:\Acadimic\SVU\ITE\S23\BPR601\projects\nestjs_bpr601_svu_server\src\api\reservations\models\schemas\reservation.schema.ts", "TypeScript", 3, 0, -3, 0
"f:\Acadimic\SVU\ITE\S23\BPR601\projects\nestjs_bpr601_svu_server\src\api\reservations\models\types\available_day_slot.type.ts", "TypeScript", 4, 0, 0, 4
"f:\Acadimic\SVU\ITE\S23\BPR601\projects\nestjs_bpr601_svu_server\src\api\reservations\models\types\available_time_slot.type.ts", "TypeScript", 4, 0, 0, 4
"f:\Acadimic\SVU\ITE\S23\BPR601\projects\nestjs_bpr601_svu_server\src\api\reservations\models\types\reservation_details.type.ts", "TypeScript", 50, 0, 4, 54
"f:\Acadimic\SVU\ITE\S23\BPR601\projects\nestjs_bpr601_svu_server\src\api\reservations\models\types\reservation_list_item.type.ts", "TypeScript", 29, 0, 4, 33
"f:\Acadimic\SVU\ITE\S23\BPR601\projects\nestjs_bpr601_svu_server\src\api\reservations\reservations.controller.ts", "TypeScript", 37, 0, 2, 39
"f:\Acadimic\SVU\ITE\S23\BPR601\projects\nestjs_bpr601_svu_server\src\api\reservations\reservations.module.ts", "TypeScript", 8, 0, 0, 8
"f:\Acadimic\SVU\ITE\S23\BPR601\projects\nestjs_bpr601_svu_server\src\api\reservations\reservations.service.ts", "TypeScript", 174, 2, 14, 190
"f:\Acadimic\SVU\ITE\S23\BPR601\projects\nestjs_bpr601_svu_server\src\api\reviews\reviews.module.ts", "TypeScript", 5, 0, 0, 5
"f:\Acadimic\SVU\ITE\S23\BPR601\projects\nestjs_bpr601_svu_server\src\api\reviews\reviews.service.ts", "TypeScript", 16, 0, 3, 19
"f:\Acadimic\SVU\ITE\S23\BPR601\projects\nestjs_bpr601_svu_server\src\api\sideorders\models\schema\sideorder.schema.ts", "TypeScript", 3, 0, 0, 3
"f:\Acadimic\SVU\ITE\S23\BPR601\projects\nestjs_bpr601_svu_server\src\api\sideorders\sideorders.controller.ts", "TypeScript", 9, 0, 0, 9
"f:\Acadimic\SVU\ITE\S23\BPR601\projects\nestjs_bpr601_svu_server\src\api\sideorders\sideorders.service.ts", "TypeScript", 21, 0, 0, 21
"f:\Acadimic\SVU\ITE\S23\BPR601\projects\nestjs_bpr601_svu_server\src\api\users\models\schemas\user.schema.ts", "TypeScript", -2, 0, 0, -2
"f:\Acadimic\SVU\ITE\S23\BPR601\projects\nestjs_bpr601_svu_server\src\api\users\models\types\user_details.type.ts", "TypeScript", -2, 0, 0, -2
"f:\Acadimic\SVU\ITE\S23\BPR601\projects\nestjs_bpr601_svu_server\src\auth\auth.service.ts", "TypeScript", -1, 0, 0, -1
"f:\Acadimic\SVU\ITE\S23\BPR601\projects\nestjs_bpr601_svu_server\src\auth\dtos\auth.signin.DTO.ts", "TypeScript", -1, 0, 0, -1
"f:\Acadimic\SVU\ITE\S23\BPR601\projects\nestjs_bpr601_svu_server\src\auth\dtos\auth.signup.DTO.ts", "TypeScript", -3, 0, -1, -4
"f:\Acadimic\SVU\ITE\S23\BPR601\projects\nestjs_bpr601_svu_server\src\global\helper\mongoose_middleware.helper.ts", "TypeScript", 15, 0, 0, 15
"Total", "-", 504, 2, 31, 537